1111111
10EC0P1
1000011
1111111
