111111111111
111111111111
111111111111
111EE1111111
111111P11111
111111111111
11C111111111
111111111111
