11111111
111111111
111111
1
111111111111
1111111111
1
1
111111

