11111111111
11E11111111
1111111C111
1CCCEP11111
11111111111
