111111111111111111111111
100000000000000000000001
111111111111111111111101
100000000000000000000001
1011111111111111111111C1
1000000000000000000000C1
101111111111111111111101
101000000000000000000001
101011111111111111111101
101010000000000000000101
101010000000000000010101
101010000000000000010101
101010000000000000010101
10101CCE0000000000010101
101010000000000000010101
101011111111111111110101
1010CCCCCCCCCCCCCC000101
101111111111111111111101
1000000000000000000000P1
111111111111111111111111
