111111111111111111111111
1P0C00000E00000000000001
111110000000000000000001
111100000000000000000001
100000100000000000000001
101110100000000000000001
100000100000000000000001
100000100000000000000001
100000100000000000000001
100000100000000000000001
100000100000000000000001
100000100000000000000001
100000100000000000000001
100000100000000000000001
100010100000000000000001
100110100000000000000001
101011100000000000000001
100000100000000000000001
111111111111111111111111
