111111111111111111111111
1P0000000000000000000001
111111111111111111111101
100000000000000000000001
101111111111111111111111
100000000000000000000001
101111111111111111111111
101000000000000000000001
101011111111111111111101
101010000000000000000101
101010000000000000010101
101010000000000000010101
101010000000000000010101
10101CCE0000000000010101
101010000000000000010101
101011111111111111110101
1010CCCCCCCCCCCCCC000101
101111111111111111111101
100000000000000000000001
111111111111111111111111
