111111111111111111111111
1P0000001110000000000001
111110000100000000000001
111100000000000000000001
100000100000000000000001
10111111E111111111111111
100000101000000000000001
100000101011111111111101
100000101010000000000101
100000101010111111110101
1000001010101C0000010101
100000101010111111010101
100000101010111111010101
100111111111000000010101
100010101011111111110101
10011C101000000000000101
101011101111111111111101
100000100000000000000001
111111111111111111111111
